2,2,2,2,2,2,7,7,2,2,2,2,2,2,2,2,2,2,7,7,2,2,2,2,2,2,2,2,2,2
2,2,2,2,2,2,7,7,2,2,2,2,2,2,2,2,2,2,7,7,2,2,2,2,2,2,2,2,2,2
2,2,2,2,2,2,7,7,2,2,2,2,2,2,2,2,2,2,7,7,2,2,2,2,2,2,2,2,2,2
2,2,2,2,2,2,7,7,2,2,2,2,2,2,2,2,2,2,7,7,2,2,2,2,2,2,2,2,2,2
2,2,2,2,2,2,7,7,2,2,2,2,2,2,2,2,2,2,7,7,2,2,2,2,2,2,2,2,2,2
2,2,2,2,2,2,7,7,2,2,2,2,2,2,2,2,2,2,7,7,2,2,2,2,2,2,2,2,2,2
2,2,2,2,2,2,7,7,2,3,3,2,2,2,2,2,2,2,7,7,2,2,2,2,2,2,2,2,2,2
2,2,2,2,2,2,7,7,2,4,4,2,2,2,2,2,2,2,7,7,2,2,2,2,2,2,2,2,2,2
2,2,2,2,2,2,7,7,2,2,2,2,2,2,2,2,2,2,7,7,2,2,2,2,2,2,2,2,2,2
1,1,1,1,1,2,7,7,2,2,5,2,2,2,2,2,2,2,7,7,2,2,2,2,3,2,2,2,2,2
1,1,1,5,1,2,7,7,2,2,2,2,3,3,3,2,2,2,7,7,2,2,2,2,4,2,2,2,2,2
1,1,1,1,1,2,7,7,2,2,2,2,4,4,4,2,2,2,7,7,2,2,2,2,2,2,2,2,2,2
1,1,1,6,1,2,7,7,2,2,2,2,2,2,2,2,2,2,7,7,2,2,2,2,2,2,2,2,2,2
1,1,6,6,1,2,7,7,2,2,2,2,2,2,2,2,2,2,7,7,2,2,2,2,2,2,2,2,2,2
1,6,6,1,1,2,7,7,7,7,7,7,7,7,7,7,7,7,7,7,2,2,2,2,2,2,2,2,2,2
6,6,1,6,1,2,7,7,7,7,7,7,7,7,7,7,7,7,7,7,2,2,2,2,2,2,2,2,2,2
6,6,6,6,6,6,2,2,2,2,2,2,2,2,2,2,2,2,7,7,2,2,2,2,2,2,2,2,2,2
6,6,1,6,6,1,1,2,2,2,2,2,2,2,2,2,2,2,7,7,2,2,2,2,2,2,2,2,2,2
2,2,6,6,6,2,1,2,2,2,2,2,2,2,2,2,2,2,7,7,2,2,2,2,2,2,2,2,2,2
6,6,6,6,2,2,1,1,2,2,2,2,2,2,2,2,2,2,7,7,2,2,2,2,2,2,2,2,2,2
6,6,6,6,6,2,2,2,2,2,2,2,2,2,2,2,2,2,7,7,2,2,2,2,2,2,2,2,2,2
2,2,6,6,1,2,2,2,2,2,2,2,2,2,2,2,2,2,7,7,2,2,2,2,2,2,2,2,2,2
2,2,2,2,2,2,2,2,2,2,2,2,2,2,2,2,2,2,7,7,2,2,2,2,2,2,2,2,2,2
2,2,2,2,2,2,2,2,2,2,2,2,2,2,2,2,2,2,7,7,2,2,2,2,2,2,2,2,2,2
2,2,2,2,2,2,2,2,2,2,2,2,2,2,2,2,2,2,7,7,2,2,2,2,2,2,2,2,2,2
2,2,2,2,2,2,2,2,2,2,2,2,2,2,2,2,2,2,7,7,2,2,2,2,2,2,2,2,2,2
2,2,2,2,2,2,2,2,2,2,2,2,2,2,2,2,2,2,7,7,2,2,2,2,2,2,2,2,2,2
2,2,2,2,2,2,2,2,2,2,2,2,2,2,2,2,2,2,7,7,2,2,2,2,2,2,2,2,2,2
2,2,2,2,2,2,2,2,2,2,2,2,2,2,2,2,2,2,7,7,2,2,2,2,2,2,2,2,2,2
2,2,2,2,2,2,2,2,2,2,2,2,2,2,2,2,2,2,7,7,2,2,2,2,2,2,2,2,2,2
